1111111111111111
1E10010100C001C1
1000000C10100001
1101010P00101101
1111111111111111