1111111111111111
1P00010000C000C1
1000000C10100001
11010100001011E1
1111111111111111