11111111111111111111111
1E0000000000000C00000C1
1C0000P00000000C00000C1
10100101001000001010011
10100100101010100010011
10100100101010100010011
11111111111111111111111
